10 10
W W S W W W U U U W
 W U U U W U U U U W
W U W U U W W U U W
 W U W U W W U U W W
W U W U U U U W U W
 W U W U W W U W U W
W U W U W W W U W W
 W U W U U W E U W W
W U U W U U U W U W
 W U U U W U U U U W